0000000000000000000000000000000
0........##......##........0000
0........##......##........0000
0..%%%%%%##................0000
0..%%%%%%##..........@@@@@@0000
0##%%%%%%..................0000
0##%%%%%%..................0000
0%%%%%%%%......##..#######.0000
0%%%%%%%%......##..#######.0000
0%%%%%%%%########..##...#..0000
0%%%%%%%%######....##...#..0000
0%%%%%%%%....##.........#..0000
0%%%%%%%%....##.........#..0000
0..%%........@@@@@@....%%..0000
0..%%........@@@@@@....%%..0000
0..................%%%%%%%%0000
0..##..##..........%%%%%%%%0000
0###..####..#######%%%%%%%%0000
0###..####..#......%%%%%%%%0000
0..........##......%%%%%%%%0000
0..........##..####%%%%%%%%0000
0##....@...........%%%%%%..0000
0##....@...........%%%%%%..0000
0####..@...........%%%%%%..0000
0####..@....####...%%%%%%..0000
0@@####.....#..#...##......0000
0@@####.....#..#...##......0000
0000000000000000000000000000000