..####................##..
..####................##..
####......####..........##
####....##########......##
##.....#############....@@
##.....###############....
@@....#################...
......#################...
.....###......######..#...
.....#..........####..#...
~~...#..@...@...###.......
~~...#..@...@...###.......
....##..........###...~~~~
....##..####....###...~~~~
....################......
....################......
...##################.....
...##################.....
..####################....
......############........
..####..########..####..##
..######..####..######..##
##..####........####..####
##.........####.......####
@@##.......#..#.....####@@
@@##.......#..#.....####@@